ADB = "countries/Adaraba.txt"
AKN = "countries/An_Khorgan.txt"
AGR = "countries/Angrast.txt"
ANF = "countries/Gondor.txt"
ANU = "countries/Annulefnui.txt"
ART = "countries/Arthedain.txt"
BER = "countries/Beornings.txt"
BYR = "countries/Byrig.txt"
CAR = "countries/Cardolan.txt"
CGN = "countries/Carreglyn.txt"
COL = "countries/Colgrin.txt"
CUV = "countries/Cuivienen.txt"
DAG = "countries/Dagorland.txt"
DAI = "countries/Druedain.txt"
DAL = "countries/Dale.txt"
DFN = "countries/Dunfearn.txt"
DOR = "countries/Dorwinion.txt"
DPG = "countries/Dalpygi.txt"
DUN = "countries/Dunfells.txt"
DRU = "countries/Drulad.txt"
DTH = "countries/Dathabha.txt"
DYR = "countries/Dyria.txt"
EDL = "countries/Ered_Luin.txt"
ERG = "countries/Eregion.txt"
ERE = "countries/Erebor.txt"
FAN = "countries/Fangorn.txt"
FOR = "countries/Forodwaith.txt"
GDB = "countries/Gundabad.txt"
GLD = "countries/Dol_Guldur.txt"
GON = "countries/Gondor.txt"
HAR = "countries/Harad.txt"
HIL = "countries/Hildorien.txt"
HOL = "countries/Hollin.txt"
HRN = "countries/Harondor.txt"
HST = "countries/Harestolad.txt"
HTH = "countries/Hitherlands.txt"
HVK = "countries/Hairaverkien.txt"
IRN = "countries/Isenrun.txt"
ISN = "countries/Isengard.txt"
ITH =  "countries/Gondor.txt"
KND = "countries/Khand.txt"
KRG = "countries/Karagrim.txt"
KST = "countries/Kheysart.txt"
KZD = "countries/Khazad_Dum.txt"
LIN = "countries/Lindon.txt"
LGR = "countries/Lograth.txt"
LOR = "countries/Lorien.txt"
NEN = "countries/Nan_Engui.txt"
NIF = "countries/Nan_i_Feryth.txt"
MAG = "countries/Magriag.txt"
MBL = "countries/Mirobel.txt"
MED = "countries/Medloshukain.txt"
MIR = "countries/MÃ®rvan.txt"
MOR = "countries/Mordor.txt"
MST = "countries/Misty_Mountains.txt"
LOG = "countries/Logath.txt"
PNG = "countries/Gondor.txt"
ORI = "countries/Orocarni.txt"
PRI = "countries/Parth_Iaur.txt"
RAF = "countries/Rafinfalas.txt"
RDR = "countries/Rhudaur.txt"
REE = "countries/Reedwater.txt"
RIV = "countries/Rivendell.txt"
RLM = "countries/Relmether.txt"
ROH = "countries/Rohan.txt"
SAG = "countries/Sagath.txt"
SAR = "countries/Saralain.txt"
SHI = "countries/Shire.txt"
SRB = "countries/Surikher.txt"
STK = "countries/Starkmoors.txt"
TAW = "countries/Tawarteleh.txt"
ULG = "countries/Ulgath.txt"
UMB = "countries/Umbar.txt"
WHT = "countries/White_Mountain_Rebels.txt"
WND = "countries/Windy_Mountains.txt"
WOD = "countries/Woodland_Realm.txt"
RUN = "countries/Rhun.txt"